A9
......................
......................
....C.C111111...C.....
.T111111...C11111111E.
....C.C...............
.........C22222.C.....
....C..2222...222222E.
.T222222..............
....C.....C..333333...
.......3333333..C.3...
....C.C3..C....3333...
.T333333.......3......
....C.C.......C33333E.
......................
......................
