A4,B2;A4,B4,C3;A5,B5,C6
......................
..........C...........
....C..C11111.C.......
..T111111.C.11111111E.
....C..C......C.......
..........C.2222..22E.
.....C.222222..2C.2...
..T22222..C....2222...
.....C..........C.....
......C.....C333333...
..T33333...333..C.3...
......C3..C3C.....33E.
.......33333..........
......................
......................
