A2,B3;A3,B3,C2;A3,B4,C4
......................
....C.C...............
..T11111...C11111111E.
....C.C111111.........
...........C..........
....C.C2222222........
..T22222...C.2222222E.
....C.................
.......3333333........
....C.C3....C3........
..T33333..C333........
....C.C....3..........
..........C333333333E.
......................
......................
