A9
......................
......................
....C.C111111...C.....
..T11111...C11111111E.
....C.C...............
.........C22222.C.....
....C..2222...222222E.
..T22222..............
....C.....C..333333...
.......3333333..C.3...
....C.C3..C....3333...
..T33333.......3......
....C.C.......C33333E.
......................
......................
