A3,B2,C1;A5,B4,C2;A6,B5,C3
......................
..........C...........
...C.C.111111.C.......
.T111111..C.11111111E.
...C.C........C.......
.........C22222.......
....C.C2222.C.222222E.
.T222222.......C......
....C.C.C.C..333333...
...C...3333333....3...
.T333333C.C...C3333...
...C..C........3......
..............C33333E.
......................
......................
