......................
..A...................
...........A..........
.T1111111.............
........1.............
....11111......11111E.
....1..........1......
....111111111111......
......................
......................
......................
.T2222222222222.......
..............2.......
..............222222E.
......................
