......................
.T333333333333333333E.
....C.................
.T1111111.............
....C...1.............
....11111......11111E.
....1.C........1......
...C111111111111......
......C...............
......................
....C.........C.......
.T2222222222222.......
....C.........2.......
.............C222222E.
......................
