......................
..A...................
...........A..........
111111111.............
........1.............
........1......1E111..
....11111......1......
....1..........1......
....1..........1......
....111111111111......
......................
......................
......................
......................
......................
