A2,B3;A3,B3,C2;A3,B4,C4
......................
......C...............
..T11111...C11111111E.
......C111111.........
...........C..........
......C222222.........
..T22222...C22222222E.
......................
.......3333333........
......C3....C3........
..T33333..C333........
......C....3..........
..........C333333333E.
......................
......................
