......................
......................
......................
111111111.............
........1.............
........1......1E1E1..
....11111......1......
....1..........1......
....1..........1......
....111111111111......
......................
......................
......................
......................
......................
